D  empty.png
EA empty.png
NO empty.png
P  empty.png
SO empty.png,empty.png
WE empty.png

C  255,255,255
F  255,255,255

1111111
1000001
100X001
100S001
1000001
1000001
1111111