D  desert/door_1.png
EA desert/wall_ea_1.png
NO desert/wall_no_1.png
P  desert/sprite_1.png,desert/sprite_2.png,desert/sprite_3.png,desert/sprite_4.png,desert/sprite_5.png,desert/sprite_6.png,desert/sprite_7.png,desert/sprite_8.png,desert/sprite_9.png,desert/sprite_10.png
SO desert/wall_so_1.png
WE desert/wall_we_1.png

C  187,152,112
F  187,152,112

        1111111111 11111111111111
        100P00P00P11000P00000P001
        1D11000P01110011110000001
        1P0100E000P00P10010P00001
111111111D110P00P1110011110000P01
1P000P00000P00P00111P00P000011111
1111P1111101110111P000P011111
1111D11111111111110101001P0011111
11000001      111100P0P0100P00P01
10P0P001      1001100P00P10001111
100000011111110P011P1010010001
11P00P011101010111110111D0P011
11110111 1111101 101111010011
11111111 111 11 1111 1 1111