D  jail/door_1.png
EA jail/wall_ea_1.png
NO jail/wall_no_1.png
P  jail/sprite_1.png,jail/sprite_1.png,jail/sprite_1.png,jail/sprite_2.png,jail/sprite_3.png,jail/sprite_4.png,jail/sprite_5.png,jail/sprite_6.png,jail/sprite_6.png,jail/sprite_6.png,jail/sprite_6.png,jail/sprite_5.png,jail/sprite_4.png,jail/sprite_3.png,jail/sprite_2.png
SO jail/wall_so_1.png,jail/wall_so_1.png,jail/wall_so_2.png,jail/wall_so_2.png
WE jail/wall_we_1.png

C  50,50,50
F  30,30,30

11111111111111111111111111111111111111111111111111111111111111111111111111111
1000100010001000100010001000000P000000000000000000P01000100010001000100010001
1000100010001000100010001000111110000P000000111110001000100010001000100010001
10001000100010001000100010001   1000010100001   10001000100010001000100010001
11D111D111D111D111D111D11000111110P011D110001111100011D111D111D111D111D111D11
100000000P0P00000000000000000000000110001100000000000000000000000000000000001
100010001000100010P0100010P000000000D0P0D0000P00000010P010P010P0100010P010001
10P00000000000000000000000000000P00110001100000000000000000000000000000000001
11D111D111D111D111D111D110001111100011D110001111100011D111D111D111D111D111D11
10001000100010001000100010P01   1000010100001   10P01000100010001000100010001
10001000100010001000100010001111100000000000111110001000100010001000100010001
1000100010N010001000100010000000000000000P00000000001000100010001000100010001
11111111111111111111111111111111111111111111111111111111111111111111111111111