D  maze/door_1.png
EA maze/wall_ea_1.png
NO maze/wall_no_1.png
P  maze/sprite_2.png,maze/sprite_1.png,maze/sprite_2.png,maze/sprite_2.png,maze/sprite_2.png,maze/sprite_2.png,maze/sprite_2.png,maze/sprite_2.png,maze/sprite_2.png,maze/sprite_2.png,maze/sprite_2.png,maze/sprite_2.png,maze/sprite_2.png,maze/sprite_2.png
SO maze/wall_so_1.png
WE maze/wall_we_1.png,maze/wall_we_2.png,maze/wall_we_3.png,maze/wall_we_4.png,maze/wall_we_5.png,maze/wall_we_6.png,maze/wall_we_7.png,maze/wall_we_8.png,maze/wall_we_9.png,maze/wall_we_10.png,maze/wall_we_11.png,maze/wall_we_12.png,maze/wall_we_12.png

C  20,10,10
F  5,20,5

11111111111111111111111111111111111111111
1000D010100010000000100000001010001000001
11111010P01011101011101111101010111111101
10100000001010001000001000000000001000001
101111P011101010P111111110P110101010P1111
10000000101000100000001010001010100000101
111111P0101110111011101011111111P01110101
10000000101010100010100010101000001010001
1011111010101110101011P01010P110101011101
10100000100000001000100000100010101000001
1110P01111111111111111101110P110111010101
10101010000010001000001010000000100010101
1011101011101011101011111110P111111010111
10000010100010001000000010000000001010101
10111111101111101011111010111110111111101
10100010000000000000001010000010000010101
10101010101111101110P11011111011101010101
10101000101000001010001000001000101000001
10111011111111111011101110101111111010111
10000010000000100010100010101010000010001
11101111111011101010111011111011111010111
1000100000000000101000101P000000101010001
10111010111110101010P11111111110101011101
10101010100000101000000000000000101010101
10101111101110101011111110111111101110111
10100000001000101010100010001000001000001
101011101110P011101010P110P11011101011101
10101000001010100010000010100010001010001
1011111111P01011111010P110101110101110111
10000010100010001000100000001010100010001
101010P0111111111111P01110101011P01010111
10101010001000100000001000100010001000001
10111110P111101110P111111011111110P111111
10000000000000101000001010101000000000001
11101110P11110101110101011101110111111P01
10100010100010001000100010000010101010001
10101110111010101111111110101011101010P01
10001000001010100000100000101000000000101
101110111110101010111011111010P0101111101
10001000001000101000001000001010101E00D01
11111111111111111111111111111111111111111